---------------------------------------
---------------------------------------
---UPPD--------------------------------
--Uu00dD-------------------------------
-Uu0000dD------------------------------
PT000000BPPPPPPPPPPPPPPPPPPPPPPPPPPPPPN
000000000000000000000000000000000000000