---------------------------------------
---------------------------------------
---------------------------------------
---------------------------------------
---------------------------------------
PPPPPPPPPPPPPPPPPPPPPPPPPPPPPPPPPPPPPPN
000000000000000000000000000000000000000