---------------------------------------
---------------------------------------
----UPPPPPPPPr-------------------------
---U000000000R----3-------------------3
--U0000000000R-------------------------
PPT0000000000R----lPPPPPPPPPPPPPPPPPPPN
0000000000000R----L00000000000000000000