--------------------------UPD----------
-------------------------U000D---------
---UPPD-----------------U00000D--------
--Uu00dD---------------U0000000D-------
-Uu0000dD--3----------U000000000D--33--
PT000000BPPPPPPPPPPPPPT000000000BPPPPPN
000000000000000000000000000000000000000