---------------------------------------
---------------------------------------
---------------------------------------
---------------------------------------
------------------------33-------------
PPPPPPPPPPPPPPPPPPPPPPPPPPPPPPPPPPPPPPN
000000000000000000000000000000000000000