---------------------------------------
---------------------------------------
---------------------------------------
---------------------------------------
---------------------------------------
PPPPPPPPPPPPPPPPPPPPPPPPPPPPPPPPPPPPPPP
000000000000000000000000000000000000000