--------------------------UPD----------
-------------------------Uu0dD---------
---UPPD-----------------Uu000dD--------
--Uu00dD--3------------Uu00000dD---33--
-Uu0000dD-------------Uu0000000dD------
PT000000BPPPPPPPPPPPPPT000000000BPPPPPN
000000000000000000000000000000000000000