---------------------------------------
---------------------------------------
----------------------------------3----
---------------------------------------
------------------lPPPPPPPPPPPPPPPPPPPN
PPPPPPPPPPr-------L00000000000000000000
0000000000R-------L00000000000000000000