---------------------------------------
---------------------------------------
---------------------------------------
---------------------------------------
------------------33--------------3----
PPPPPPPPPPPPPPPPPPPPPPPPPPPPPPPPPPPPPPN
000000000000000000000000000000000000000