-------------------
-------------------
---UPPD------------
--Uu00dD-----------
-Uu0000dD----------
PT000000BPPPPPPPPPP
0000000000000000000