-------------------
-------------------
-------------------
-------------------
-------------------
PPPPPPPPPPPPPPPPPPP
0000000000000000000