---------------------------------------
---------------------------------------
---UPPD--------------------------------
--Uu00dD-------------------------------
-Uu0000dD------------------------------
PT000000BPPPPPPPPPPPPPPPPPPPPPPPPPPPPPP
000000000000000000000000000000000000000