--------------------------UPD----------
-------------------------Uu0dD---------
---UPPD-----------------Uu000dD--------
--Uu00dD---------------Uu00000dD-------
-Uu0000dD--3----------Uu0000000dD--33--
PT000000BPPPPPPPPPPPPPT000000000BPPPPPN
000000000000000000000000000000000000000